11111111111111111111111111111111111111111111111111
10000000000000000000000000000000000000000000000001
10000000000020000000000000000000000000000000000001
10000000000000000000000000000000000000000000000001
10000000000000000000111111111111111111111111111111
10000000000000000000000000000000000000000000000001
10000000000000000000000000000000000000000000000001
10000000000000000000000000000000000000000000000001
10000000000000000000000000000000000000000000000001
10000000000000000000000000000000000000000000000001
10000000000000000000000000000000000000000000000001
10000000000000000200000000000000000000000000000001
10000000000000000000000000000000000000000000000001
10000000000000000000000300000000000000000000000001
10000000000000000000000000000000000000000000000001
10000000000000000000000000000000000000000000000001
10000000000000000000000000000000000000000000000001
10000000000000000000000000000000000000000000000001
10000000000000000000000000000000000000000000000001
11111111111111111111111111111111111111111111111111