11111111111111111111111111111111111111111111111111
10000000000000000000000000000000000000000000000001
10000000000000000000000000000000000000000000000001
10000000000000000000000000000000000000000000000001
10000000000000000000111111111111111111111111111111
10000000000000000000000000000000000000000000000001
10000000000000000000000000000000000000000000000001
10000000000000000000000000000000000000000000000001
10000000000000000000000000000000000000000000000001
10000000000000000000000000000000000000000000000001
10000000000000000000000000000000000000000000000001
10000000000000000000000000000000000000000000000001
10000000000000000000000000000000000000000000000001
10000000000000000000000300000000000000000000000001
10000000000000000000000000000000000000000000000001
10000000000000000000000000000000000000000000000001
10000000000000000000000000000000000000000000000001
10000000000000000000000000000000000000000000000001
10000000000000000000000000000000000000000000000001
10000000000000000000000000000000000000000000000001
10000000000000000000000000000000000000000000000001
10000000000000000000000000000000000000000000000001
10000000000000000000000000000000000000000000000001
10000000000000000000000000000000000000000000000001
11111111111111111111000000000011111111111111110011
11111111111111111111000000000011111111111111110011
10000000000000000011000000000011000000000000000001
10000000000000000011000000000011000000000000000001
10000000000000000011000000000011000000000000000001
10000000000000000011000000000011000000000000000001
10000000000000000011000000000011000000000000000001
10000000000000000011000000000011000000000000000001
10000000000000000011000000000011000000000000000001
10000000000000000011000000000011000000000000000001
10000000000000000011000000000011000000000000000001
10000000000000000011000002000011000000000000000001
10000000000000000011000000000011000000000000000001
10000000000000000011000000000011000000000000000001
10000000000000000011000000000011000000000000000001
10000000000000000011000000000011000000000000000001
10000000000000000011000000000011000000000000000001
10000000000000000011000000000011000000000000000001
10000000000000000011000000000011000000000000000001
10000000000000000011000000000011000000000000000001
10000000000000000011000000000011000000000000000001
10000000000000000011000002000011000000000000000001
10000000000000000011000000000011000000000000000001
10000000000000000000000000000000000000000002000001
10000000000000000000000000000000000000000000000001
11111111111111111111111111111111111111111111111111