11111111111111111111111111111111111111111111111111
10000000000000000000100000000010000000000000000001
10000000000000000000000000000000000000000000000001
10000000000000000000000000000000000000000000000001
10000000000000000000000000000000000000000000000001
10000000000000000000000000000000000000000000000001
10000000000000000000000000000000000000000000000001
10000000000000000000000000000000000000000000000001
10000000000000000000100000000010000000000000000001
11111111111111111111111000011111111111111111111111
10000000000000000000100000000010000000000000000001
10000000000000000000100000000010000000000000000001
10000000000000000000100000000010000000000000000001
10000000000000000000100000000010000000000000000001
10000002000000000000100000000010000000000200000001
10000000000000000000100000000010000000000000000001
10000000000000000000100000000010000000000000000001
10000000000000000000100000000010000000000000000001
10000000000000000000100000000010000000000000000001
11111111111111111111111111111111111111111111111111