11111111111111111111111111111111111111111111111111
10000000000000000000100000000010000000000000000001
10000000000000000000000000000000000000000000000001
10000000000000000000000000000000000000000000000001
10000000000000000000000000000000000000000000000001
10000000000000000000000000000000000000000000000001
10000000000000000000000000000000000000000000000001
10000000000000000000000000000000000000000000000001
10000000000000000000100000000010000000000000000001
11111111111111111111111000011111111111111111111111
10000000000000000000100000000010000000000000000001
10000000000000000000100000000010000000000000000001
10000000000000000000100000000010000000000000000001
10000000000000000000100000000010000000000000000001
10000002000000000000100000000010000000000200000001
10000000000000000000100000000010000000000000000001
10000000000000000000100000000010000000000000000001
10000000000000000000100000000010000000000000000001
10000000000000000000100000000010000000000000000001
11001111111111111111111000011111111111111111110011
10000000000000000000100000000010000000000000000001
10000000000000000000100000000010000000000000000001
10000000000000000000000000000010000000000000000001
10000000000000000000000000000010000000000000000001
10000000000000000000000000000010000000002000000001
10000000000000000000000000000010000000000000000001
10000000000000000000000000000010000000000000000001
10000000000000000000100000000010000000000000000001
10000000000000000000100000000010000000000000000001
11001111111111111111111000011111111111111111110011
10000000000000000000100000000010000000000000000001
10000000000000000000100000000010000000000000000001
10000000000000000000100000000010000000000000000001
10000000000000000000100000000010000000000000000001
10000000000000000000100000000010000000000000000001
10000000000000000000100000000010000000000000000001
10000000000000000000100000000010000000000000000001
10000000000000000000100000000010000000000000000001
10000000000000000000100000000010000000000000000001
11001111111111111111111000011111111111111111110011
10000000000000000000100000000010000000000000000001
10000000000000000000000000000010000000000000000001
10000000000000000000000000000010000000000000000001
10000000000000000000100000000010000000000000000001
10000000000000000000100000000010000000000000000001
10000000000000000000100000000010000000000000000001
10000000000000000000100000000000000000000000000001
10000000000000000000100000000000000000000000000001
10000000000000000000100000000010000000000000000001
11111111111111111111111111111111111111111111111111