11111111111111111111111111111111111111111111111111
10000000000000000000011000000000000000000000000001
10030000000000000000011000000000000000000000000001
10000000000000000000011000000000000000000000000001
10000000000000000000011111111111111100000000000111
10000000000000000000000000000000000000000000000001
10000000000000000000000000000000000000000000000001
10030000000000000000000000000000000000000000000001
10000000000000000000000000000000000000000000000001
11111111111111111110000000111111111111111111111111
10000000000000000000000000000020000000000000000001
10000000000000000000000000011111110000000000000001
10000000000000000000000000000000000000000000000001
10000000000000000000000000000000000000000000000001
10000000000000000000000000000000000000000000000001
10000000000000000000000000000000000000000000000001
10000000000000000000000000000000000000000000000001
10000000000000000000000000000000000000000000000001
10000000000000000000000000000000000000000000000001
11111111111111111111111111111111111111111111111111