11111111111111111111111111111111111111111111111111
10000000000000000000011000000000000000000000000001
10000000000000000000011000000000000000000000000001
10000000000000000000011000000000000000000000000001
10000000000000000000011111111111111100000000000111
10000000000000000000000000000000000000000000000001
10000000000000000000000000000000000000000000000001
10000000000000000000000000000000000000000000000001
10000000000000000000000000000000000000000000000001
11111111111111111110000000111111111111111111111111
10000000000000000000000000000000000000000000000001
10000000000000000000000000011111110000000000000001
10000000000000000000000000000000000000000000000001
10000000000000000000000000000000000000000000000001
10000000000000000000000000000000000000000000000001
10000000000000000000000000000000000000000000000001
10000000000000000000000000000000000000000000000001
10000000000000000000000000000000000000000000000001
10000000000000000000000000000000000000000000000001
10000000000000000000000000000000000000000000000001
11111000000000000000000000000000000000000000000001
11111000000000000000000000000000000000000000000001
11111000000000000000000000000000000000000000000001
11111000000000000000000000000000000000000000000001
11111000000000000000000000000000000000000000000001
10000000000000000000000000000000000000000000000001
10000000000000000000000000000000000000000000000001
10000000000000000000000000000000000000000000000001
10000000000000000000000200000000000000000000000001
10000000000000000000000000000000000000000000000001
10000000001111111111111111111111111111000000000001
10000000000000000000000000000000000000000000000001
10000000000000000000000000000000000000000000000001
10000000110000011000000000011111100000000111111111
10000000110000011000000000011111100000000111111111
10000000110000011000000000011000000000000001111111
10000000110000011000000000011000000000000001111111
10000000110000011000000000011000000000000001111111
10000000110000011000000000011000000000000001111111
10000000110000011000000000011000000000000001111111
10000000110000011000000000011000000000000001111111
10000000110020011000000000011000000000000001111111
10000000110000011000000000011000000000000001111111
10000000111111111000000000011000000000000001111111
10000000111111111000000000011000000000000001111111
10000000000000000000000000011000000000000001111111
10000000000000000000000000011000000000000001111111
10000000000000000000000000011000000200000001111111
10000000000000000000000000011000000000000001111111
11111111111111111111111111111111111111111111111111